1111111111111111111111111111111
1000000000000000000000000000001
1000000001111111111111000000001
1000001111000000000001111000001
1000011100000000000000011100001
100011000000000C000000000110001
1001100000000000000000000011001
1011000000000000000000000001101
1010000C0000111P1110000C0000101
1010000000011000001100000000101
1010000000110010100110000000101
101111111111001E100111111111101
1010000000110011100110000000101
1010000000011000001100000000101
1010000000001111111000000000101
1011000000000000000000000001101
1001100000000000000000000011001
1000110000000000000000000110001
1000011100000000000000011100001
1000001111000000000001111000001
1000000001111111111111000000001
1000000000000000000000000000001
1111111111111111111111111111111
