11111111111111111111111111111111111111111
1P000100000000000100000000000000000000001
10000000000000000C000000000000000C0000001
10000000000000000000000000000000000000001
10101010101010101010100010100000001111111
10000000000000000000000000111C10011111111
100000000000C0000000000000011110001111111
10000010000000000110001010101000001111111
10001000000000000000001011111011110011111
10011100000100000000001011110000000111111
10001001000100001000001011110000000001111
10000000000000011100001011111001111111111
10000000000000000000001E11111C00111111111
11111111111111111111111111111111111111111
