11111
1P001
10001
1C0E1
11111
