NO ./assets/textures/Wall1.xpm
SO ./assets/textures/Wall2.xpm
WE ./assets/textures/Wall3.xpm
EA ./assets/textures/Wall4.xpm

C 51,53,51
F 36,85,1

	111111111111111111111111111111
	100001000000000000000000000001
	100000001000000001111111100001
11111000000000000000000000N0111111
100000011111111111000000100001
10000001         1000000111111
10000001         10000001
10000001         10000001
10000001         10000001
1000000111111111110000001
1000000000000000000000001
11110111111111011100000011111
11110111111111011101010010001
11000000110101011100000000001
10000000000000001100000010001
10000000000000001100000010001
100000000000000011010100100011111
110000011101010111110111100000001
11110111 1110101 1 1111 100011101
11111111 1111111 111111111111 111
