NO ./assets/textures/1Sand.xpm
SO ./assets/textures/2Sand.xpm
WE ./assets/textures/3Sand.xpm
EA ./assets/textures/4Sand.xpm

C 77,172,240
F 249,217,150

1111111111111111111111111
1000000000000000000000001
1000000000000000000000001
1000000000000000000000001
100000000000S00000000000
1000000000000000000000001
1000000000000000000000001
1000000000000000000000001
1000000000000000000000001
1111111111111111111111111
