11111111111111111
1PA000C00000000E1
11111111111111111
