1111111
111111P1
111110001
111100C001
111000E0001
111111111111
